111111111111
10C000000E01
10000000P001
10000C000U01
11111111111
