111111111111
10C000000E01
1CFC0000P001
10C00C000001
111111111111
