111111111111
10C000000E01
10000000P001
1F000C000001
111111111111
